#      ###       S
# #### ### #######
###### #   ####  #
# #### ###    # ##
# #### ######   ##
#             ####
#I################