#######S#
####### #
####### #
####### #
####### #
#       #
# #######
#I#######