#####################
#S                  #
# # # # # # # # # # #
# # # # # # # # # # #
# # # # # # # # # # #
# # # # # # # # # # #
# # # # # # # # # # #
# # # # # # # # # # #
# # # # # # # # # # #
# # # # # # # # # #I#
#####################
