#####################
#S     ## # ##   #  #
### ##    ##   # #  #
# ### # #  #   # #  #
# ### #    # ##   ###
# ##  ## #    ##    #
# ## # ##  ##   ### #
#  #           ##   I
#####################
