#######S#
##      #
####### #
# ## ## #
  ## ## #
#       #
# #######
#I#######