#      ###
# # ## ###
# # ## ###
# #S## ###
# # ## ###
#        #
#I########